name: test map
mode: pvp
background: 120, 80, 110

########################################################################################################################
######################           #######            ####################################################################
#                                                     ###############                         ##########################
#                                                                                                          #############
#                                                                                                          ########## ##
#                                                                                                                     ##
#                                                                                                                     ##
#                                                                                                                    ###
######          #########                      s                                                              ##########
######             ##          ######    ################################################################     ##########
######                         ######    #######          ###############################################     ##########
######                         ######                     ###############################################      #########
######  #                      ######                    #############################################         #########
######  #                      ######    ########        #############################################      ############
######  #                  ##########    #############################################################           #######
######  #   ##########""""###########    ###     ########################################################        #######
######  #         ###################    ###     ##########      ##########################################      #######
######            ##################              ###                                  #############           #########
######               #######                                                                 ######            #########
######  ####                                                                                                   #########
######                                          #########                                                   ############
######          ##                              #############                                             ##############
######          ###                             #############                                                ###########
######          ####                         ################                          #########             ###########
#########    ###########                   #############################################################################
##############################"""""""""""""#############################################################################
