name: test map
mode: pvp

#######################################################
######################           #######            ###
#                                                     #
#                                                     #
#                                                     #
#                                                     #
#                                                     #
# s                                                  ##
######          #########                      s     ##
######  #          ##          ######    ##############
######  #                      ######    ##############
######  #                      ######    ##############
######  #                      ######    ##############
######  #                      ######    ##############
######  #                  ##########    ##############
######  #   ##########""""###########    ###     ######
######            ###################    ###     ######
######            ##################             ######
######               #######                     ######
######  ####                                     ######
######                                          #######
######          ##                              #######
######          ###                             #######
######          ####                         ##########
#########    ###########                   ############
##############################"""""""""""""############
